{
  "head0":"https://barsonyj.github.io/json/heads/head10.png",
  "head1":"https://barsonyj.github.io/json/heads/head11.png",
  "level": [
    [ 0,1,0,0,1,0,0 ],
    [ 0,1,0,0,1,0,0 ],
    [ 0,1,0,0,1,0,0 ],
    [ 0,1,0,0,1,0,0 ],
    [ 0,1,0,0,1,0,0 ],
    [ 0,1,0,0,1,0,0 ],
    [ 1,1,1,1,0,1,1 ],
    [ 0,1,0,0,1,0,0 ],
    [ 0,1,0,0,1,0,0 ],
    [ 1,0,1,1,1,1,1 ],
    [ 0,1,0,0,1,0,0 ],
    [ 0,1,0,0,1,0,0 ],
    [ 0,1,0,0,1,0,0 ]
  ]
}
