{
  "head0":"https://barsonyj.github.io/json/heads/head30.png",
  "head1":"https://barsonyj.github.io/json/heads/head31.png",
  "level": [
    [ 0,1,1,1,1,1,0 ],
    [ 0,1,1,1,1,1,0 ],
    [ 1,1,0,0,0,0,1 ],
    [ 0,1,1,1,1,1,0 ],
    [ 1,0,1,0,0,0,1 ],
    [ 0,1,1,1,1,1,0 ],
    [ 1,0,0,1,0,0,1 ],
    [ 0,1,1,1,1,1,0 ],
    [ 1,0,0,0,1,0,1 ],
    [ 0,1,1,1,1,1,0 ],
    [ 1,0,0,0,0,1,1 ],
    [ 0,1,1,1,1,1,0 ],
    [ 0,1,1,1,1,1,0 ]
  ]
}
