{
  "head0":"https://barsonyj.github.io/json/heads/head50.png",
  "head1":"https://barsonyj.github.io/json/heads/head51.png",
  "level": [
    [ 0,1,1,1,1,1,0 ],
    [ 1,0,1,1,1,1,0 ],
    [ 1,1,0,1,1,1,0 ],
    [ 1,1,1,0,1,1,0 ],
    [ 1,1,1,1,0,1,0 ],
    [ 1,1,1,1,1,0,0 ],
    [ 1,1,1,1,1,1,1 ],
    [ 1,1,1,1,1,0,0 ],
    [ 1,1,1,1,0,1,0 ],
    [ 1,1,1,0,1,1,0 ],
    [ 1,1,0,1,1,1,0 ],
    [ 1,0,1,0,1,1,0 ],
    [ 0,1,1,1,1,1,0 ]
  ]
}
