{
  "head0":"https://barsonyj.github.io/json/heads/whead.png",
  "head1":"https://barsonyj.github.io/json/heads/rhead.png",
  "level": [
    [ 0,1,0,0,1,0,0 ],
    [ 1,0,1,1,0,1,1 ],
    [ 0,1,0,0,1,0,0 ],
    [ 0,1,0,0,1,0,0 ],
    [ 0,1,0,0,1,0,0 ],
    [ 0,1,0,0,1,0,0 ],
    [ 1,0,1,1,0,1,1 ],
    [ 0,1,0,0,1,0,0 ],
    [ 0,1,0,0,1,0,0 ],
    [ 1,0,1,1,0,1,1 ],
    [ 0,1,0,0,1,0,0 ],
    [ 0,1,0,0,1,0,0 ],
    [ 0,1,0,0,1,0,0 ]
  ]
}
