{
  "head0":"https://barsonyj.github.io/json/heads/head40.png",
  "head1":"https://barsonyj.github.io/json/heads/head41.png",
  "level": [
    [ 1,0,0,0,0,0,0 ],
    [ 0,1,0,0,0,0,0 ],
    [ 0,0,1,0,0,0,0 ],
    [ 0,0,0,1,0,0,0 ],
    [ 0,0,0,1,0,0,0 ],
    [ 0,0,0,1,0,0,0 ],
    [ 0,0,0,1,0,0,0 ],
    [ 0,0,0,1,0,0,0 ],
    [ 0,0,0,1,0,0,0 ],
    [ 0,0,0,1,0,0,0 ],
    [ 0,0,0,0,1,0,0 ],
    [ 0,0,0,0,0,1,0 ],
    [ 0,0,0,0,0,0,1 ]
  ]
}
